###################
#       #   ♦     #
# ##### # ##### ###
#     # #   #   # #
# # # ### # # # # #
#   #     #♦#   # #
####### # # # #####
#     # #   #     #
# ### ### ####### #
#♦  #     #   ♦   #
### ####### #######
#       #   #     #
##### ### ### # # #
#     #   #   # # #
# # ##### ### # # #
# # ♦   #     # ♦ #
# ##### #### ######
#  ♦      #       #
####### ##### #####
#       #   #  ♦  #
# ### ### # # #####
#   # #   # #     #
### # ### # ##### #
#   # #   #   #   #
##### # ##### # # #
#     #   #  ♦  ###
# ####### ####### #
#       #  ♦      #
########## ########
